su			切换用户
sync 		强制把内存的数据写入到硬盘
man(info)	在系统里查询帮助文档，比较详细，--help为命令自带的比较简短的参数说明
shutdown    option 		time  			警告信息 (shutdown 会先停掉系统的服务再关机)
		 -r 重启       -t/几秒后关机
		 -h 关机 	    20:20
		 -k 仅发送参数
run-level(执行等级)	用init来切换   例如：init 0表示关机
					level 0   关机
					level 3   纯文本模式
					level 5   图形接口模式
					level 6   重新启动
date 		日期
cal			日历
bc			计算器
账号信息都记录在/etc/passwd里, 密码都记录在/etc/shadow里，组名都记录在/etc/group里
chgrp		改变所属群组
		-R 	递归更改
chown		改变拥有者
chmod		改变权限
		777(rwx+rwx+rwx) 或者a-x,u-x,g-x,o-x(不知道原有权限的情况下进行的权限变更操作)
		r-- 某用户具有用ls查询该目录列表的权限，但不能cd进入,能否进入目录是x来决定，目录的可执行权限就是能否进入

ls -l --full-time 显示目录的完整时间

各目录作用 
bin		单人维护模式下还能被操作的指令，可以被root和一般账号使用，例如cat chmod chown date mv
boot	开机用到的档案，包括linux核心档案以及开机选单与开机所需配置文件等
dev		在linux系统中，任何装置与接口设备都是以档案的形态存在于这个目录当中的
etc		系统主要的配置文件几乎都在这个目录内，例如账号密码，各种服务的启始档等
home	系统默认的用户家目录
lib		开机时会用到的函式库，以及在执行/bin或/sbin底下的指令会呼叫的函式库
media   可移除的装置，包括软盘，光盘，DVD等装置都暂时挂载于此
mnt		暂时挂载某些额外装置可以放到这个目录里，很早以前作用和media是相同的，有了media之后，就用来暂时挂载用了
opt 	安装软件
sbin    Linux 有非常多指令是用来设定系统环境的，这些指令只有 root 																					才能够利用来『设定』系统，其他用户最多只能用来『查询』而已（系统管理员可以使用的命令）
srv		service的缩写,系统启动服务时可以访问的数据库目录
tmp		临时文件
usr		Unix Software Resource(Unix操作系统软件资源)的缩写

lsb_release		查看当前系统的发行版信息
uname -r 		查看linux版本号